###########
S+++  #   #
###+### ###
#  +  #   #
# #+### ###
# #+++++++E
# ##### ###
# # #     #
# # # #####
# #       #
###########