#################E###
#   #       # # #+++#
# ##### ##### # # #+#
#   # #   #   # # #+#
### # # ##### # # #+#
# # #     #   # # #+#
# # # ####### # ###+#
#   # # # # # #   #+#
# # # # # # # ### #+#
# #         #    +++#
##### # #########+###
#     # #     # #+# #
##### ####### # #+# #
#         #   #+++# #
# ### ### ### #+### #
# #   #    +++++    #
##### # ###+### #####
#     # #  +# #   # #
####### ###+# # ### #
#       #  +  #     #
###########S#########