#########################################
#       #         # #   # # #     #   # #
### ### ##### ### # # ### # # # ### ### #
#     #       #             # # # #   # #
# ##### # # ### ### ####### ### # # ### #
# #     # # #   #     # #       #     # #
# ### ######### ### ### ####### ### ### #
#   # #           #   #                 #
# ### # # # ### ### ### ##### ######### #
#   # # # # #   # # #   #   # # #     # #
# ######### ### # ##### ### ### # ##### #
# #         # # #     # # # #       # # #
# ##### ##### ##### ### # # # # ### # # #
# #   #   #         #   # #   # #  +++++#
### ############### ##### # # # ###+# #+#
S+++++++++  #           #   # # #+++# #+E
# ##### #+##### ### ######### ###+##### #
#     # #+#   # #   #   #   # # #+    # #
##### ###+### ##### # ##### ### #+##### #
# #   #  +++++++++++++# # #+++++++    # #
# ##### # ### # ### #+# # #+# # # # ### #
#       # #   # #   #+++++++# # # #   # #
# ##### ##### # ### # ### # # ######### #
# #   # #     #   # #   # # #   #   # # #
### # # # ### ####### ##### ### # # # # #
#   #   #   # # # #     #     # # #     #
############# # # # # ################# #
#           # #     #   #     #     #   #
########### ####### # ##### ####### ### #
#                   #     #             #
### # # # ### # # ### ####### # # ### # #
# # # # # #   # #   #   #   # # # # # # #
# ##### # ####### ### ##### # # # # # ###
#   #   # # #       #     #   # #   #   #
# ####### # ### ### ### ### ##### ##### #
#   # #   #     #   #   # #   #   # #   #
# ### # ### ##### # # # # ##### # # # # #
# #       #     # # # # #       #   # # #
# ### ####### ### # ####### # # # ##### #
#         #   #   #     #   # # #   #   #
#########################################